111111111111
1P00000000C1
101111111101
1C00000C0101
101111111101
1C0000000101
101111111101
1E00000000C1
111111111111
