1111111111
1P0000C001
1011101101
1C010000C1
101C111011
1E00C00001
1111111111
