111111111
1P00000C1
101111101
1C000C101
101111101
1E00000C1
111111111
